{
  "name": "multi_megatower1_0_floor1",
  "refpalette": "c70cities:multi_megatower1_0_floor1_palette",
  "xsize": 16,
  "zsize": 16,
  "slices": [
    [
      "                ",
      "                ",
      "                ",
      "                ",
      "                ",
      "                ",
      "                ",
      "                ",
      "                ",
      "                ",
      "                ",
      "             a  ",
      "             bcc",
      "           abdee",
      "            fe  ",
      "            fe  "
    ],
    [
      "                ",
      "                ",
      "                ",
      "                ",
      "                ",
      "                ",
      "                ",
      "                ",
      "                ",
      "                ",
      "                ",
      "             a  ",
      "             bcc",
      "           abdgg",
      "            fh  ",
      "            fh  "
    ],
    [
      "                ",
      "                ",
      "                ",
      "                ",
      "                ",
      "                ",
      "                ",
      "                ",
      "                ",
      "                ",
      "                ",
      "             a  ",
      "             bcc",
      "           abdgg",
      "            fh  ",
      "            fh  "
    ],
    [
      "                ",
      "                ",
      "                ",
      "                ",
      "                ",
      "                ",
      "                ",
      "                ",
      "                ",
      "                ",
      "                ",
      "             a  ",
      "             bcc",
      "           abdgg",
      "            fh  ",
      "            fh  "
    ],
    [
      "                ",
      "                ",
      "                ",
      "                ",
      "                ",
      "                ",
      "                ",
      "                ",
      "                ",
      "                ",
      "                ",
      "                ",
      "                ",
      "             dgg",
      "             i  ",
      "             i  "
    ],
    [
      "                ",
      "                ",
      "                ",
      "                ",
      "                ",
      "                ",
      "                ",
      "                ",
      "                ",
      "                ",
      "                ",
      "                ",
      "                ",
      "             djj",
      "             kll",
      "             kll"
    ]
  ]
}