{
  "name": "multi_megatower1_7_floor1",
  "refpalette": "c70cities:multi_megatower1_7_floor1_palette",
  "xsize": 16,
  "zsize": 16,
  "slices": [
    [
      "ab              ",
      "ab              ",
      "ab              ",
      "ab              ",
      "abc             ",
      "ab              ",
      "ab              ",
      "ab              ",
      "ab              ",
      "ab              ",
      "ab              ",
      "abc             ",
      "ab              ",
      "ab              ",
      "ab              ",
      "ab              "
    ],
    [
      "                ",
      "                ",
      "                ",
      "                ",
      "  c             ",
      "                ",
      "                ",
      "                ",
      "                ",
      "                ",
      "                ",
      "  c             ",
      "                ",
      "                ",
      "                ",
      "                "
    ],
    [
      "                ",
      "                ",
      "                ",
      "                ",
      "  c             ",
      "                ",
      "                ",
      "                ",
      "                ",
      "                ",
      "                ",
      "  c             ",
      "                ",
      "                ",
      "                ",
      "                "
    ],
    [
      "                ",
      "                ",
      "                ",
      "                ",
      "  c             ",
      "                ",
      "                ",
      "                ",
      "                ",
      "                ",
      "                ",
      "  c             ",
      "                ",
      "                ",
      "                ",
      "                "
    ],
    [
      "                ",
      "                ",
      "                ",
      "                ",
      "  c             ",
      "                ",
      "                ",
      "                ",
      "                ",
      "                ",
      "                ",
      "  c             ",
      "                ",
      "                ",
      "                ",
      "                "
    ],
    [
      "  d             ",
      "  d             ",
      "  d             ",
      "  d             ",
      "  c             ",
      "  d             ",
      "  d             ",
      "  d             ",
      "  d             ",
      "  d             ",
      "  d             ",
      "  c             ",
      "  d             ",
      "  d             ",
      "  d             ",
      "  d             "
    ]
  ]
}