{
  "name": "multi_militarycamp1_0_floor2",
  "refpalette": "c70cities:multi_militarycamp1_0_floor2_palette",
  "xsize": 16,
  "zsize": 16,
  "slices": [
    [
      "                ",
      "                ",
      "                ",
      "                ",
      "                ",
      "                ",
      "                ",
      "  ab ab         ",
      "   b  b         ",
      "                ",
      "   c c          ",
      "    d           ",
      "   c c          ",
      "                ",
      "                ",
      "                "
    ],
    [
      "                ",
      "                ",
      "                ",
      "                ",
      "                ",
      "                ",
      "                ",
      "                ",
      "                ",
      "                ",
      "   c c          ",
      "    e           ",
      "   c c          ",
      "                ",
      "                ",
      "                "
    ],
    [
      "                ",
      "                ",
      "                ",
      "                ",
      "                ",
      "                ",
      "                ",
      "                ",
      "                ",
      "                ",
      "   ccc          ",
      "   cec          ",
      "   ccc          ",
      "                ",
      "                ",
      "                "
    ],
    [
      "                ",
      "                ",
      "                ",
      "                ",
      "                ",
      "                ",
      "                ",
      "                ",
      "                ",
      "   f f          ",
      "  ghihj         ",
      "   kdl          ",
      "  ghmhj         ",
      "   n n          ",
      "                ",
      "                "
    ],
    [
      "                ",
      "                ",
      "                ",
      "                ",
      "                ",
      "                ",
      "                ",
      "                ",
      "                ",
      "                ",
      "   c c          ",
      "    d           ",
      "   c c          ",
      "   o            ",
      "                ",
      "                "
    ],
    [
      "                ",
      "                ",
      "                ",
      "                ",
      "                ",
      "                ",
      "                ",
      "                ",
      "                ",
      "     p          ",
      "  qc c          ",
      "    e           ",
      "   c c          ",
      "                ",
      "                ",
      "                "
    ]
  ]
}