{
  "name": "multi_megatower1_2_floor7",
  "refpalette": "c70cities:multi_megatower1_2_floor7_palette",
  "xsize": 16,
  "zsize": 16,
  "slices": [
    [
      "           abc  ",
      "            bc  ",
      "           defcc",
      "             ebb",
      "             d g",
      "                ",
      "                ",
      "                ",
      "                ",
      "                ",
      "                ",
      "                ",
      "                ",
      "                ",
      "                ",
      "                "
    ],
    [
      "           a h  ",
      "             h  ",
      "           defhh",
      "             e  ",
      "             d g",
      "                ",
      "                ",
      "                ",
      "                ",
      "                ",
      "                ",
      "                ",
      "                ",
      "                ",
      "                ",
      "                "
    ],
    [
      "           a    ",
      "                ",
      "           def  ",
      "             e  ",
      "             d g",
      "                ",
      "                ",
      "                ",
      "                ",
      "                ",
      "                ",
      "                ",
      "                ",
      "                ",
      "                ",
      "                "
    ],
    [
      "           a    ",
      "                ",
      "           def  ",
      "             e  ",
      "             d g",
      "                ",
      "                ",
      "                ",
      "                ",
      "                ",
      "                ",
      "                ",
      "                ",
      "                ",
      "                ",
      "                "
    ],
    [
      "           a h  ",
      "             h  ",
      "           defhh",
      "             e  ",
      "             d g",
      "                ",
      "                ",
      "                ",
      "                ",
      "                ",
      "                ",
      "                ",
      "                ",
      "                ",
      "                ",
      "                "
    ],
    [
      "           a ijk",
      "             ijj",
      "           defll",
      "             e  ",
      "             d g",
      "                ",
      "                ",
      "                ",
      "                ",
      "                ",
      "                ",
      "                ",
      "                ",
      "                ",
      "                ",
      "                "
    ]
  ]
}