{
  "name": "multi_communitycenter_3_floor1",
  "refpalette": "c70cities:multi_communitycenter_3_floor1_palette",
  "xsize": 16,
  "zsize": 16,
  "slices": [
    [
      "                ",
      "                ",
      "                ",
      "                ",
      "                ",
      "                ",
      "                ",
      "        ~       ",
      "              aa",
      "              ab",
      "              a ",
      "              a ",
      "              a ",
      "              ab",
      "              ab",
      "              a "
    ],
    [
      "                ",
      "                ",
      "                ",
      "                ",
      "                ",
      "                ",
      "                ",
      "        ~       ",
      "                ",
      "               b",
      "                ",
      "                ",
      "                ",
      "               b",
      "               b",
      "                "
    ],
    [
      "                ",
      "                ",
      "                ",
      "                ",
      "                ",
      "                ",
      "                ",
      "        ~       ",
      "                ",
      "               b",
      "                ",
      "                ",
      "                ",
      "               b",
      "               b",
      "                "
    ],
    [
      "                ",
      "                ",
      "                ",
      "                ",
      "                ",
      "                ",
      "                ",
      "        ~       ",
      "                ",
      "               c",
      "                ",
      "                ",
      "                ",
      "               c",
      "               c",
      "                "
    ],
    [
      "                ",
      "                ",
      "                ",
      "                ",
      "                ",
      "                ",
      "                ",
      "        ~    ddd",
      "             ddd",
      "             dde",
      "             dde",
      "             dde",
      "             dde",
      "             dde",
      "             dde",
      "             dde"
    ],
    [
      "                ",
      "                ",
      "                ",
      "                ",
      "                ",
      "                ",
      "                ",
      "        ~       ",
      "                ",
      "                ",
      "                ",
      "                ",
      "                ",
      "                ",
      "                ",
      "                "
    ]
  ]
}