{
  "name": "multi_militarycamp1_0_floor1",
  "refpalette": "c70cities:multi_militarycamp1_0_floor1_palette",
  "xsize": 16,
  "zsize": 16,
  "slices": [
    [
      "                ",
      "                ",
      "                ",
      "                ",
      "                ",
      "                ",
      "                ",
      "                ",
      "                ",
      "                ",
      "   aaa          ",
      "   abac         ",
      "   aaa          ",
      "                ",
      "                ",
      "                "
    ],
    [
      "                ",
      "                ",
      "                ",
      "                ",
      "                ",
      "                ",
      "                ",
      "                ",
      "                ",
      "   d d          ",
      "  efgfh         ",
      "   ijk          ",
      "  eflfh         ",
      "   m m          ",
      "                ",
      "                "
    ],
    [
      "                ",
      "                ",
      "                ",
      "                ",
      "                ",
      "                ",
      "                ",
      "                ",
      "                ",
      "    n           ",
      "    a           ",
      "   aja          ",
      "    a           ",
      "                ",
      "                ",
      "                "
    ],
    [
      "                ",
      "                ",
      "                ",
      "                ",
      "                ",
      "                ",
      "                ",
      "                ",
      "                ",
      "                ",
      "    a           ",
      "   abao         ",
      "    a           ",
      "    p           ",
      "                ",
      "                "
    ],
    [
      "                ",
      "                ",
      "                ",
      "                ",
      "                ",
      "                ",
      "                ",
      "                ",
      "                ",
      "                ",
      "    a           ",
      "  qaba          ",
      "    a           ",
      "                ",
      "                ",
      "                "
    ],
    [
      "                ",
      "                ",
      "                ",
      "                ",
      "                ",
      "                ",
      "                ",
      "                ",
      "                ",
      "                ",
      "   aaa          ",
      "   ara          ",
      "   aaa          ",
      "                ",
      "                ",
      "                "
    ]
  ]
}