{
  "name": "multi_pumpjack_2_floor1",
  "refpalette": "c70cities:multi_pumpjack_2_floor1_palette",
  "xsize": 16,
  "zsize": 16,
  "slices": [
    [
      "                ",
      "a               ",
      "a               ",
      "b               ",
      "                ",
      "                ",
      "                ",
      "                ",
      "                ",
      "                ",
      "      ~         ",
      "                ",
      "                ",
      "                ",
      "                ",
      "b               "
    ],
    [
      "                ",
      "a               ",
      "a               ",
      "c               ",
      "c               ",
      "c               ",
      "c               ",
      "c               ",
      "c               ",
      "c               ",
      "c     ~         ",
      "c               ",
      "c               ",
      "c               ",
      "c               ",
      "c               "
    ],
    [
      "                ",
      "a               ",
      "a               ",
      "                ",
      "                ",
      "                ",
      "                ",
      "                ",
      "                ",
      "                ",
      "      ~         ",
      "                ",
      "                ",
      "                ",
      "                ",
      "b               "
    ],
    [
      "                ",
      "a               ",
      "a               ",
      "a               ",
      "a               ",
      "a               ",
      "a               ",
      "a               ",
      "a               ",
      "a               ",
      "a     ~         ",
      "a               ",
      "a               ",
      "a               ",
      "a               ",
      "a               "
    ],
    [
      "dd              ",
      "dd              ",
      "dd              ",
      "dd              ",
      "dd              ",
      "dd              ",
      "dd              ",
      "dd              ",
      "dd              ",
      "dd              ",
      "dd    ~         ",
      "dd              ",
      "dd              ",
      "dd              ",
      "dd              ",
      "dd              "
    ],
    [
      "                ",
      "                ",
      "                ",
      "                ",
      "                ",
      "                ",
      "                ",
      "                ",
      "                ",
      "                ",
      "      ~         ",
      "                ",
      "                ",
      "                ",
      "                ",
      "                "
    ]
  ]
}